R 960 520

NO ./textures/wall_cartoon_1.xpm
SO ./textures/wall_cartoon_2.xpm
WE ./textures/wall_2.xpm
EA ./textures/wall_cartoon_4.xpm

S ./textures/sprite_1.xpm
F 180,180,180
C 85,70,240

1111111111111111111111111
1000000000110000000000001
10110000011100000020000011111
10210000000000000000000000001
10110000011100000000000011111
1000000000110000011101111
1111011111111101110000001
1111211111111101110000001
1100000011010101110000001
10002000000000001100000011111
10000000000000001101010000001
11000000110101011111010000W01
11110111111101011111010000001
11111111111111111111111111111
