R 960 520

NO ./textures/wall_cartoon_1.xpm
SO ./textures/wall_cartoon_2.xpm
WE ./textures/wall_2.xpm
EA ./textures/wall_cartoon_4.xpm

S ./textures/sprite_1.xpm
F 180,180,180
C 85,70,240

11
101
1001
10201
100001
1000201
10000001
111101111
1000000011
10002000001
100000000001
10N0000000001
10000000000001
111111111111111
