R 960 520

NO ./textures/wall_cartoon_1.xpm
SO ./textures/wall_cartoon_2.xpm
WE ./textures/wall_2.xpm
EA ./textures/wall_cartoon_4.xpm

S ./textures/sprite_1.xpm
F 180,180,180
C 85,70,240

11111111111111111111
10S01000000000000001
10001011111111111101
11011000000000000101
10001111111111110101
10001000000000010101
10201000000000000101
10001000000000011101
11011000022000010001
11011000022000010001
11011000000000010001
11011000000000010001
10011000000000010001
10111000000000010001
10000000000000011011
11111111111111111111
