R 960 520

NO ./textures/wall_cartoon_1.xpm
SO ./textures/wall_cartoon_2.xpm
WE ./textures/wall_2.xpm
EA ./textures/wall_cartoon_4.xpm

S ./textures/sprite_1.xpm
F 180,180,180
C 85,70,240

1 1 1 1 1 1 1 1 1 1 1 1 1 1 1 1 1 1 1 1
1 0 S 0 1 0 0 0 0 0 0 0 0 0 0 0 0 0 0 1
1 0 0 0 1 0 1 1 1 1 1 1 1 1 1 1 1 1 0 1
1 1 0 1 1 0 0 0 0 0 0 0 0 0 0 0 0 1 0 1
1 0 0 0 1 1 1 1 1 1 1 1 1 1 1 1 0 1 0 1
1 0 0 0 1 0 0 0 0 0 0 0 0 0 0 1 0 1 0 1
1 0 2 0 1 0 0 0 0 0 0 0 0 0 0 0 0 1 0 1
1 0 0 0 1 0 0 0 0 0 0 0 0 0 0 1 1 1 0 1
1 1 0 1 1 0 0 0 0 2 2 0 0 0 0 1 0 0 0 1
1 1 0 1 1 0 0 0 0 2 2 0 0 0 0 1 0 0 0 1
1 1 0 1 1 0 0 0 0 0 0 0 0 0 0 1 0 0 0 1
1 1 0 1 1 0 0 0 0 0 0 0 0 0 0 1 0 0 0 1
1 0 0 1 1 0 0 0 0 0 0 0 0 0 0 1 0 0 0 1
1 0 1 1 1 0 0 0 0 0 0 0 0 0 0 1 0 0 0 1
1 0 0 0 0 0 0 0 0 0 0 0 0 0 0 1 1 0 1 1
1 1 1 1 1 1 1 1 1 1 1 1 1 1 1 1 1 1 1 1
