R 960 520

NO ./textures/wall_cartoon_1.xpm
SO ./textures/wall_cartoon_2.xpm
WE ./textures/wall_2.xpm
EA ./textures/wall_cartoon_4.xpm

S1 ./textures/sprite_1.xpm
#S2 ./textures/pillar.xpm
S3 ./textures/portal.xpm
S4 ./textures/teleport.xpm
S5 ./textures/GG.xpm
S6 ./textures/pine.xpm
S7 ./textures/cactus.xpm
S8 ./textures/monokuma.xpm

F 180,180,180
C 85,70,240

1111111111111111111111111
1000000000110000000000001
10000000011100000020000011111
10151000000000000000000000061
10111000011100000000000011111
1000000000110000011101111
1111111111111111111111111
1111411111111141110000001
1100000011919101110088001
10000300000000001100000011111
10000000000000000001010000001
11070700119121211111010000W01
11119111111191911111910000091
11111111111111111111111111111
