R 960 520

NO ./textures/wall_cartoon_1.xpm
SO ./textures/wall_cartoon_2.xpm
WE ./textures/wall_2.xpm
EA ./textures/wall_cartoon_4.xpm

S ./textures/sprite_1.xpm
F 180,180,180
C 85,70,240

 11111111 11111111
1000000011100000001
1000000000000000001
 11111111011111111
    10000000001
    10000000001
    10000000001
    10000000001
    10000000001
    10000000001
    10000000001
    10000000001
    10000000001
    10000N00001
     100000001
      1001001
       10101
        111
